//MAP CONVERTED BY dmm2tgm.py THIS HEADER COMMENT PREVENTS RECONVERSION, DO NOT REMOVE
"a" = (
/turf/closed/wall/mineral/titanium/survival/pod,
/area/ship/storage)
"b" = (
/turf/template_noop,
/area/template_noop)
"c" = (
/obj/machinery/light,
/turf/open/floor/carpet/black,
/area/ship/storage)
"d" = (
/obj/structure/cable{
	icon_state = "2-8"
	},
/obj/structure/cable{
	icon_state = "4-8"
	},
/obj/machinery/light{
	dir = 1
	},
/obj/structure/closet/crate/science,
/obj/item/circuitboard/machine/protolathe/department/cargo,
/obj/item/clothing/glasses/science,
/obj/item/reagent_scanner,
/obj/item/circuitboard/machine/rdserver,
/obj/item/circuitboard/machine/circuit_imprinter,
/obj/item/circuitboard/machine/autolathe,
/obj/item/storage/box/stockparts/basic,
/obj/item/circuitboard/computer/rdconsole,
/turf/open/floor/plating,
/area/ship/storage)
"e" = (
/obj/structure/table/wood/fancy/black,
/obj/item/reagent_containers/food/drinks/drinkingglass{
	pixel_x = 7;
	pixel_y = 2
	},
/obj/effect/spawner/lootdrop/three_course_meal,
/turf/open/floor/carpet/black,
/area/ship/storage)
"f" = (
/obj/structure/sign/mining/survival{
	dir = 8
	},
/turf/closed/wall/mineral/titanium/survival/pod,
/area/ship/storage)
"g" = (
/obj/structure/sink/kitchen{
	dir = 4;
	pixel_x = -13
	},
/obj/machinery/airalarm/directional/south,
/turf/open/floor/carpet/black,
/area/ship/storage)
"h" = (
/obj/structure/window/reinforced/survival_pod{
	dir = 8
	},
/obj/structure/cable{
	icon_state = "2-4"
	},
/turf/open/floor/carpet/black,
/area/ship/storage)
"i" = (
/obj/structure/cable{
	icon_state = "2-4"
	},
/turf/open/floor/carpet/black,
/area/ship/storage)
"j" = (
/obj/structure/cable{
	icon_state = "2-8"
	},
/obj/structure/cable{
	icon_state = "4-8"
	},
/turf/open/floor/plating,
/area/ship/storage)
"k" = (
/obj/structure/sign/mining/survival,
/turf/closed/wall/mineral/titanium/survival/pod,
/area/ship/storage)
"l" = (
/obj/machinery/power/terminal{
	dir = 8
	},
/obj/structure/cable{
	icon_state = "0-4"
	},
/obj/item/mining_scanner,
/obj/item/mining_scanner,
/obj/item/gun/energy/kinetic_accelerator,
/obj/item/gun/energy/kinetic_accelerator,
/obj/item/clothing/suit/hooded/explorer,
/obj/item/clothing/suit/hooded/explorer,
/obj/item/clothing/mask/gas/explorer,
/obj/item/clothing/mask/gas/explorer,
/obj/item/clothing/glasses/meson,
/obj/item/clothing/glasses/meson/prescription,
/obj/structure/closet/secure_closet/miningcloset,
/obj/item/survivalcapsule,
/obj/item/shovel,
/obj/item/pickaxe/mini,
/obj/item/stack/sheet/mineral/sandbags,
/obj/item/storage/box/emptysandbags,
/turf/open/floor/plating,
/area/ship/storage)
"m" = (
/obj/structure/chair/comfy/black,
/obj/item/cardboard_cutout{
	desc = "A cardboard cutout of a xenomorph maid.";
	icon_state = "cutout_lusty";
	name = "lusty xenomorph maid"
	},
/obj/structure/window/reinforced/survival_pod{
	dir = 1
	},
/turf/open/floor/carpet/black,
/area/ship/storage)
"n" = (
/obj/structure/sign/poster/contraband/lusty_xenomorph,
/turf/closed/wall/mineral/titanium/survival/pod,
/area/ship/storage)
"o" = (
/obj/structure/fans/tiny,
/obj/machinery/door/airlock/survival_pod/glass,
/obj/structure/cable{
	icon_state = "1-2"
	},
/turf/open/floor/pod,
/area/ship/storage)
"p" = (
/obj/machinery/power/smes,
/turf/open/floor/plating,
/area/ship/storage)
"q" = (
/obj/structure/cable{
	icon_state = "2-4"
	},
/obj/structure/cable{
	icon_state = "4-8"
	},
/obj/machinery/suit_storage_unit/independent/mining/eva,
/turf/open/floor/plating,
/area/ship/storage)
"r" = (
/obj/structure/cable{
	icon_state = "2-4"
	},
/obj/structure/cable{
	icon_state = "4-8"
	},
/obj/machinery/light{
	dir = 1
	},
/turf/open/floor/plating,
/area/ship/storage)
"s" = (
/obj/structure/cable{
	icon_state = "1-4"
	},
/obj/structure/cable{
	icon_state = "1-8"
	},
/turf/open/floor/plating,
/area/ship/storage)
"t" = (
/obj/machinery/microwave{
	pixel_y = -2
	},
/obj/structure/window/reinforced/survival_pod{
	dir = 1
	},
/obj/structure/table/wood/fancy/black{
	pixel_y = -9
	},
/turf/open/floor/carpet/black,
/area/ship/storage)
"u" = (
/turf/open/floor/pod,
/area/ship/storage)
"v" = (
/obj/structure/window/reinforced/survival_pod{
	dir = 1
	},
/obj/structure/displaycase{
	alert = 0;
	desc = "A display case containing an expensive forgery, probably.";
	pixel_y = -4;
	req_access_txt = "48";
	start_showpiece_type = /obj/item/fakeartefact
	},
/turf/open/floor/carpet/black,
/area/ship/storage)
"w" = (
/obj/machinery/power/terminal,
/obj/structure/cable,
/turf/open/floor/plating,
/area/ship/storage)
"x" = (
/obj/structure/closet/crate,
/obj/item/storage/toolbox/mechanical,
/obj/item/stack/sheet/mineral/plasma/five,
/obj/item/storage/box/lights/bulbs,
/obj/item/stack/sheet/mineral/titanium/twenty,
/obj/item/stack/sheet/metal/fifty,
/obj/item/stack/sheet/glass/fifty,
/obj/item/storage/toolbox/electrical,
/turf/open/floor/plating,
/area/ship/storage)
"y" = (
/obj/machinery/door/airlock/external/glass,
/obj/docking_port/mobile{
	can_move_docking_ports = 1;
	dir = 2
	},
/obj/structure/fans/tiny,
/turf/open/floor/plating,
/area/ship/storage)
"z" = (
/obj/structure/sign/mining,
/turf/closed/wall/mineral/titanium/survival/pod,
/area/ship/storage)
"A" = (
/obj/machinery/power/smes/shuttle/precharged{
	dir = 1
	},
/obj/structure/window/reinforced/spawner/east{
	dir = 2
	},
/obj/machinery/door/window{
	dir = 1
	},
/obj/structure/cable{
	icon_state = "0-2"
	},
/turf/open/floor/plating,
/area/ship/storage)
"B" = (
/obj/structure/table/survival_pod,
/obj/item/storage/firstaid/regular,
/obj/item/storage/firstaid/brute{
	pixel_x = 5
	},
/turf/open/floor/pod,
/area/ship/storage)
"C" = (
/turf/open/floor/plating,
/area/ship/storage)
"D" = (
/obj/structure/cable,
/obj/machinery/power/shuttle/engine/electric{
	dir = 1
	},
/turf/open/floor/plating,
/area/ship/storage)
"E" = (
/obj/machinery/door/airlock/external/glass,
/obj/structure/fans/tiny,
/turf/open/floor/plating,
/area/ship/storage)
"F" = (
/obj/machinery/door/window/survival_pod{
	dir = 1
	},
/turf/open/floor/carpet/black,
/area/ship/storage)
"G" = (
/obj/structure/sign/mining/survival{
	dir = 4
	},
/turf/closed/wall/mineral/titanium/survival/pod,
/area/ship/storage)
"H" = (
/obj/machinery/power/port_gen/pacman,
/obj/structure/cable{
	icon_state = "0-8"
	},
/obj/item/wrench,
/turf/open/floor/plating,
/area/ship/storage)
"I" = (
/obj/structure/tubes,
/obj/item/kirbyplants/random,
/turf/open/floor/pod,
/area/ship/storage)
"J" = (
/obj/structure/sign/mining/survival{
	dir = 1
	},
/turf/closed/wall/mineral/titanium/survival/pod,
/area/ship/storage)
"K" = (
/obj/structure/cable{
	icon_state = "1-8"
	},
/turf/open/floor/carpet/black,
/area/ship/storage)
"L" = (
/obj/structure/toilet/secret{
	secret_type = /obj/item/kitchen/knife/combat/survival
	},
/turf/open/floor/pod,
/area/ship/storage)
"M" = (
/obj/structure/window/reinforced/survival_pod{
	density = 0;
	dir = 9
	},
/obj/structure/cable{
	icon_state = "1-2"
	},
/turf/open/floor/carpet/black,
/area/ship/storage)
"N" = (
/obj/machinery/light{
	dir = 4;
	light_color = "#DDFFD3"
	},
/obj/structure/table/wood/fancy/black,
/obj/item/reagent_containers/food/drinks/drinkingglass{
	pixel_x = 7;
	pixel_y = 2
	},
/obj/item/reagent_containers/food/drinks/bottle/wine{
	pixel_x = -6;
	pixel_y = 10
	},
/obj/machinery/power/apc/auto_name/east,
/obj/machinery/power/terminal{
	dir = 4
	},
/obj/structure/cable{
	icon_state = "0-8"
	},
/obj/item/areaeditor/shuttle,
/turf/open/floor/carpet/black,
/area/ship/storage)
"O" = (
/obj/structure/chair/comfy/black{
	dir = 1
	},
/turf/open/floor/carpet/black,
/area/ship/storage)
"P" = (
/obj/structure/tank_dispenser/oxygen,
/turf/open/floor/plating,
/area/ship/storage)
"Q" = (
/obj/structure/fans,
/turf/open/floor/pod,
/area/ship/storage)
"R" = (
/obj/machinery/light{
	dir = 8
	},
/turf/open/floor/plating,
/area/ship/storage)
"S" = (
/obj/machinery/shower,
/obj/item/soap/deluxe,
/obj/structure/curtain{
	alpha = 240;
	color = "#454545";
	icon_state = "bathroom-closed";
	open = 0
	},
/turf/open/floor/pod,
/area/ship/storage)
"U" = (
/obj/machinery/cryopod{
	dir = 4
	},
/obj/machinery/computer/cryopod{
	dir = 4;
	pixel_x = -25
	},
/turf/open/floor/pod,
/area/ship/storage)
"V" = (
/obj/structure/window/reinforced/survival_pod{
	dir = 8;
	layer = 3
	},
/obj/machinery/door/window/survival_pod{
	dir = 1
	},
/turf/open/floor/carpet/black,
/area/ship/storage)
"W" = (
/obj/structure/bed/pod,
/obj/item/bedsheet/black,
/turf/open/floor/pod,
/area/ship/storage)
"X" = (
/obj/machinery/computer/helm,
/turf/open/floor/pod,
/area/ship/storage)
"Y" = (
/obj/item/gps/computer,
/turf/open/floor/pod,
/area/ship/storage)
"Z" = (
/obj/machinery/light{
	dir = 4
	},
/turf/open/floor/plating,
/area/ship/storage)

(1,1,1) = {"
b
b
b
b
b
b
a
a
G
a
a
"}
(2,1,1) = {"
b
b
b
b
b
b
k
p
R
C
y
"}
(3,1,1) = {"
a
f
a
f
a
f
a
l
C
a
z
"}
(4,1,1) = {"
J
Q
U
B
t
g
a
q
w
A
D
"}
(5,1,1) = {"
a
X
u
u
F
c
a
r
w
A
D
"}
(6,1,1) = {"
z
Y
W
I
v
i
o
s
x
a
b
"}
(7,1,1) = {"
a
S
V
h
M
K
a
j
w
A
D
"}
(8,1,1) = {"
J
L
m
N
e
O
a
d
w
A
D
"}
(9,1,1) = {"
a
G
a
a
n
G
a
H
C
a
z
"}
(10,1,1) = {"
b
b
b
b
b
b
k
P
Z
C
E
"}
(11,1,1) = {"
b
b
b
b
b
b
a
a
G
a
a
"}
