//MAP CONVERTED BY dmm2tgm.py THIS HEADER COMMENT PREVENTS RECONVERSION, DO NOT REMOVE
"a" = (
/turf/closed/wall/mineral/titanium,
/area/ship/bridge)
"d" = (
/obj/structure/window/reinforced/fulltile/shuttle,
/turf/open/floor/plating,
/area/ship/bridge)
"g" = (
/obj/machinery/power/shuttle/engine/electric{
	dir = 8
	},
/obj/structure/cable{
	icon_state = "0-8"
	},
/obj/structure/window/reinforced{
	dir = 8
	},
/turf/open/floor/plating,
/area/ship/bridge)
"j" = (
/obj/machinery/computer/helm{
	dir = 4
	},
/turf/open/floor/mineral/titanium/blue,
/area/ship/bridge)
"s" = (
/obj/machinery/power/smes/shuttle{
	dir = 8
	},
/obj/structure/cable{
	icon_state = "0-4"
	},
/obj/machinery/door/window/westright,
/turf/open/floor/plating,
/area/ship/bridge)
"w" = (
/obj/machinery/power/smes/shuttle{
	dir = 8
	},
/obj/structure/cable{
	icon_state = "0-4"
	},
/obj/machinery/door/window/westleft,
/turf/open/floor/plating,
/area/ship/bridge)
"y" = (
/obj/item/pickaxe/drill,
/obj/item/pickaxe/drill,
/obj/item/pickaxe/drill,
/obj/item/t_scanner/adv_mining_scanner/lesser,
/obj/item/t_scanner/adv_mining_scanner/lesser,
/obj/item/t_scanner/adv_mining_scanner/lesser,
/obj/item/storage/bag/ore,
/obj/item/storage/bag/ore,
/obj/item/storage/bag/ore,
/obj/item/weldingtool/experimental,
/obj/item/clothing/head/welding,
/obj/item/areaeditor/shuttle,
/obj/item/tank/internals/oxygen,
/obj/item/tank/internals/oxygen,
/obj/item/tank/internals/oxygen,
/obj/item/clothing/mask/gas,
/obj/item/clothing/mask/gas,
/obj/item/clothing/mask/gas,
/obj/item/storage/firstaid/advanced,
/obj/item/storage/backpack/duffelbag/med/surgery,
/obj/item/storage/firstaid/o2,
/obj/item/storage/toolbox/mechanical/old,
/obj/item/storage/box/stockparts/basic,
/obj/item/circuitboard/machine/autolathe,
/obj/structure/table,
/obj/item/clothing/suit/space/solgov,
/obj/item/clothing/suit/space/solgov,
/obj/item/clothing/suit/space/solgov,
/obj/item/clothing/head/helmet/space/solgov,
/obj/item/clothing/head/helmet/space/solgov,
/obj/item/clothing/head/helmet/space/solgov,
/obj/item/gun/ballistic/automatic/pistol/solgov,
/obj/item/ammo_box/magazine/pistol556mm,
/obj/item/ammo_box/magazine/pistol556mm,
/obj/item/stack/sheet/mineral/uranium,
/obj/item/stack/sheet/mineral/uranium,
/obj/structure/cable{
	icon_state = "4-8"
	},
/obj/item/radio/intercom/wideband{
	pixel_y = 25
	},
/turf/open/floor/mineral/titanium/yellow,
/area/ship/bridge)
"z" = (
/turf/closed/wall/mineral/titanium/nodiagonal,
/area/ship/bridge)
"A" = (
/obj/structure/sign/poster/official/solgov_enlist,
/turf/closed/wall/mineral/titanium,
/area/ship/bridge)
"B" = (
/obj/machinery/power/terminal{
	dir = 4
	},
/obj/structure/cable{
	icon_state = "0-2"
	},
/obj/structure/cable{
	icon_state = "1-2"
	},
/obj/machinery/holopad/emergency/command,
/turf/open/floor/mineral/titanium/yellow,
/area/ship/bridge)
"E" = (
/obj/machinery/power/apc/auto_name/north,
/obj/machinery/power/terminal{
	dir = 1
	},
/obj/structure/cable{
	icon_state = "0-4"
	},
/obj/machinery/power/port_gen/pacman/super,
/turf/open/floor/plating,
/area/ship/bridge)
"G" = (
/obj/machinery/door/airlock/titanium,
/obj/structure/cable{
	icon_state = "1-2"
	},
/obj/docking_port/mobile{
	height = 6;
	name = "SolGov Exploration Pod";
	port_direction = 8;
	preferred_direction = 4;
	width = 4
	},
/obj/structure/fans/tiny,
/turf/open/floor/plating,
/area/ship/bridge)
"J" = (
/obj/structure/chair/comfy/shuttle{
	dir = 8
	},
/turf/open/floor/mineral/titanium/yellow,
/area/ship/bridge)
"U" = (
/obj/machinery/power/terminal{
	dir = 4
	},
/obj/structure/cable{
	icon_state = "0-2"
	},
/obj/structure/cable{
	icon_state = "2-8"
	},
/obj/machinery/cryopod,
/obj/machinery/light/floor,
/obj/machinery/computer/cryopod{
	pixel_y = 25
	},
/turf/open/floor/mineral/titanium/yellow,
/area/ship/bridge)

(1,1,1) = {"
a
d
d
a
"}
(2,1,1) = {"
a
E
j
d
"}
(3,1,1) = {"
a
y
J
A
"}
(4,1,1) = {"
a
U
B
G
"}
(5,1,1) = {"
a
s
w
a
"}
(6,1,1) = {"
z
g
g
z
"}
